NO ./tests/file.png
WE ./tests/file.png
EA ./tests/file.png
SO ./tests/file.png

F 220,100,0
C 255,30,1

1111111111111111111111111
1S0000000011000000000000011
101100000111000000000000001
10010000000000000000000011
100000000011000001110111111111111
1111111111011000001110000000000001
100000000011000001110111111111111
11110111111111011100000010001
11110111111111011101010010001
11110111111111011101010010001
11000000110101011100000010001
10000000000000001100000010001
10000000000000001101010010001
110000011101010111110111100111
11110111 1110101 101111010001
11111111 1111111 111111111111
