NO ./textures/eagle.png
WE ./textures/greystone.png
EA ./textures/purplestone.png
SO ./textures/redbrick.png

F 220,100,0
C 255,30,1

1111111111111111111111111
100000000011000000000000011
1011000001110000S0000000001
10010000000000000000000011
1000000000111000011101111111111111
111111111111111000001110000000000011
1111111111101110000001110000000000011
11111111111111100000111000000000001
1000000000111000011101111111111111
11110111111111011100000010001
11110111111111011101010010001
11110111111111011101010010001
11000000110101011100000010001
10000000000000001100000010001
10000000000000001101010010001
110000011101010111110111100111
11110111 1110101 101111010001
11111111 1111111 111111111111
