NO ./textures/mossy.png
WE ./textures/wood.png
EA ./textures/colorstone.png
SO ./textures/greystone.png

C 60,20,0
F 100,100,70

                          11111111111
                          10000000001
1111111111111111111111111 10000010001
1000000000000000010000001 10000000001
1000111111110000010000001110111110001
10001      10000011111100001   100001
10001111111100000100000011111   10001
1000000000000000000000001       10001
1111111111111111111111101       11111
                      101
       111111111111   101111111
       1W0000000001   10000000111
       10000111110111110000000001
       111111   10000000000000111
                111111111111111
