NO ./textures/bluestone.png
WE ./textures/greystone.png
EA ./textures/purplestone.png
SO ./textures/colorstone.png

F 55,36,199
C 44,76,107

11111111111111111111111111111111111111111111111111
1E000000000001000000000000010000100000000000100001
11111111111101000001011110010010111111111010100101
10000000000101111101010000010010000000100010111101
10011111111100000001000010010111100100111110000001
10000000010010010001110110000000100101100100111111
11110111010010011110100111111100100100000100000001
10100000010010010000100000010100100111111100000001
10111111000000000000000010010000100000000000000001
10000000011111111111111110011110111111111111111111
11111111010000000000001000001000100000000000000001
10000000010000000000001111111000100000000000000001
10011111110000000000000000000000100000000000000001
10000000000000000000000000000000100000000000000001
10000000000000000000000000000000000000000000000001
10000000000000000000000000000000100000000000000001
10000000000000000000000000000000000000000000000001
10000000000000000010000000000000100000000000000001
10000000000000000000000000000000000000000000000001
10000000000000000000000000000000000000000000000001
10000000000000000000000000000000000000000000000001
10000000000000000000000000000000000000000000000001
10000000000000000000000000000000000000000000000001
11111111111111111111111111111111111111111111111111